敌空空空空空敌空空空空空敌
空草草草草草草草草草草草空
空空空空空空空空空空空空空
空空空空空空空空空空空空空
空铁铁铁铁铁铁铁铁铁铁铁空
空空空空空空空空空空空空空
空空空空空空空空空空空空空
空砖砖砖砖砖砖砖砖砖砖砖空
空空空空空空空空空空空空空
空水水水水水水水水水水水空
空空空空空空空空空空空空空
空空空空空空空空空空空空空
空空空空空空堡空空主空空空